#############################
#M    #                     #
# ### # #########   ######  #
# #     #          #     ####
# ####### ###########  #  ###
#     #        #       #  # #
### # ######    ########  # #
#   #    ###  #     #       #
#        #    #     #       #
#  ####### #  #### ##########
#               #          I#
#############################