##########
#    #   #
#    # # #
#  M   # #
# ###### #
#        #
#### #####
#  #    I#
##########